****X******X***X*X*******
XXX**XX*XX*X*XX****XX*XX*
**X*X***X**X*X**XXX*X**X*
*XX*X*XX**XX***XX****X**X
*X**X*X*X*X**XX***X*XXX**
*X*X**X*X*X*X*XX*X***X**X
***X*X**X***X****XX*X**X*
*XXX*X*X*X*X**XXX*X**X*X*
*****X****X**XX***XX***X*
XXX*X*XX*X**X***X**XXXX**
**XX******X*X*XX*X******X
*X***XX*XXX*X*X***X*X*X**
*X*XX***X***X***X**X***X*
*X***XX*X*XXX*XXXX*X*X*X*
**X*X***X*X***X*XX**X*X**
*XX*X*X*X*X*XX****X****XX
****X**X**X*X**X*XXXXX***
*XXX*X*X*X**X*XX**X***XX*
*X***X*X**X**XX**X**X**X*
**XX*X**X**X****X**XXX***
X****X*X**X*X*X**X**X*X*X
*X*X*X**X*X*X**XX**X**X**
**X**X*X**X***X***X**X*X*
*XX*XX**X*XXXX**XX**X****
******X********XXXX***XX*