*X********X***XX********XX***XX*X*X*****XX******X*
**XX*XX*X***X****X*X*X*X***X********X*XX***X*XX***
X****XX*X*X**XX*XX*******X*XX*XX*XX***X**X*X****X*
*X*XX*******XXX****XX*XX****X***X***X**X*XX*X*X*X*
*****X*X*XX**X**XX*X**XX*XX**X*XX*X**X********X***
*X*X******XX***X****X******X***X**X*X*X*X*X*X**XX*
X****X*XX***XX***XX**X*X*X**X*X**X*X***X*X****X***
**XX***XX*X****X***X*******XX***X****XX***X*X***X*
*X***XX*****X*X*X*X**XX*XX****X**X*X****X*****X*X*
*X*X**X*X*XX*****X**X***X**XX*XX****XX*X*X*XX*X***
*****X*******X*XX**X**X***X******XX*XX*****X****X*
X*XX***X*XX*X*****X**X*X*XX*X*X*X******XX*X**X*XX*
****X*X**X**X*X*XX*X***X***XXX**XX*X*X*X****X*****
*X*X***X***X****X****X***X**X**X***X****XX*X**X*X*
*****X***X*X*X*X**XX**X*X*X**X***X***XX****X*X****
*X*XX**X*******X*X*X*XX***XX***X***XX***XX*****X*X
******X**X*X*X*********XX**XX*XX*X****XX**XX*X*X*X
*XX*XX**XX****X*X*X*XX***X*******X*X*X***XXX******
*X***X*X***X*X*******X*X*X*XX*X*X****X*X**X**XX*X*
**XX***XX*XX***X*XX*X******XX*X**X*X****X***XX****
X***X*X***X**X***XX*X*X*X*X****X**X*X*X***X****X*X
**XX**X*X**X*X*X******XX****XX**X***X**XX*XX*X***X
X***X*****X******XX*X***XX*X***X*X*X*X*******X*X**
**X***X*XX**X*XX*****XX*****X*X******X*X*X*X****X*
X***X******X*****X*X*XXX*XX*XX**XX*X*******XX*X*X*
X*X*X*X*X*XXX*X*X*****XX*XX****X****X*X*XX****X***
**X***XX***X******X*X*******XX***XX**X**X**XX**XX*
*X**XX***XX**XX*X**X*X*XX*X*XX*XX***XX*X**XX*X*XX*
**X*XX*X*X**X*****X****XX******XX*X******XX*******
X*X********X**X*X***XX****X*X*X***X*X*X*X***X*X*X*
***X*X*XX*XXX*XX**X***X*X*XX****XX********X*XX****
*X*********X***X*X**X*XX***X*XX*XX*XX*X*XX*****X*X
***X*X*X*X**XX****X*****XX**********X****X*XX*X***
*X*X******X**X*X*X**X*X**X*XX*X*X*XX*X*X***X****X*
****X*X*X*XX**XX*XX**X*X****X********X**XX**X*X***
*XX***X*X***X******X*X**X*X***XX*XX*X*X***XX****X*
****X**X*X*X*XX*XX*X***XX**X*X*********XX****XX*X*
*X*XXX**************XX****XX***XX*XX*X*X**XX******
****XXX*X*XX*XX*X*X***X*X****X*****X*****X*X*X*X*X
*XX**XX*X*********X*X*****X*X*X*XX**XX*X*X********
***X******X*XX*XX**X*X*X*X******X*X**X*****X*XX*X*
X*XX*XX*X***XX***X*X**X****XX*X****X**X*X*X*******
**X******XX***XX*X***X**X*X****X*XX*X******XX*X*X*
X***X*XX*XX*X******X***X****X*XX*X***XX*XX***X****
**X*X********X*X*X**XX*X*XX**X*****X*X****XX***XX*
X****XX*X*XX******X*XX*****X***XX*X****XX****X**X*
*X*X****X***X*X*X*X****X*X***X**X***XX****XX***X**
*X***X*X*XX**X******X*X*X**X**X**X*XXX*X*XX**X***X
***X*****XX*XX*XX*X******X*XX**X**X*X***X***XX*X*X
*X***X*X***********X*X*X******XXX*****X***XX******