*****X***X*******XX******************X*********XX*
X*XX**XX***XX*XX****X*XX*X*X*X*X*X*X***X*X*X*X****
****X****X*******X*X*****X*********X*X*X*X*X**X*X*
*X*X**XX*X*X*X*X*****X*X***X*X*X*XX*********X*****
*****X*********X*X*X**X**X****X***X*X*X*X*X*X*X*X*
*X*XX*X*XX*X*X***X**X*XX*XX*X*X*XX*******X******X*
********X***X**X**X**********X*****X*XX*X**X*XX***
*X*XX*XX**XX**X*X**X*X*X*X*X***X*X*******X******X*
*X****X**X***XX***X****X*X**X*XXX**X*X*X***X*X*X**
X*X*X**X**X*X***X**X*X*****X**XX**XX**X**X***X*X*X
****XX**X****X*XXX****XX*X***X***X**X**X*X*X*****X
*XX***X***XX****X**XX*XX**X*X**X*X*X*X*****X*X*X**
*XX*X*XX*X**X*X***X*X***X**X**X****X***X*X****X**X
***X***X*X*XX***X*X***X***X**X**X*X**X*****XX*X*X*
*X**XX********X*****X*X*XX**X**XX***X**XX*X*X*****
**X*X*X*X*X*X*XX*XX*****XX*XXX***XX**X*X******X*X*
X*******X******X****X*X****XX**X***X*****X*X*X***X
**X*X*XX**X*X*X**X*X*X*X*X****X*X*X**X*X****XX*X**
*X****X**XX*XX**X**X*****X*XX*X****X****X*X****X*X
X**XX***X******X**X**X*X*****X**X*X*X*X****X*X****
**X**X*X**XX*X***XX*X****X*X***XX*****XX*X**X**XX*
*X**X****XX****X*X**XX*XX****X***X*X*X****XX**X*X*
*X*X*X*X***XX*X****X***X**XX**XX*****X*XX****X***X
***X*****X*XX***XX*X*X**X*X*X****X*X****XX*XX**X**
*X***X*X*X****X*******X*X*****X*X****XX**XX***X*X*
**XX***X***X*X**X*X*X****X*X*X****X*XX*X****XX**X*
X**X*XX**XX****X*XX*X*XX*XX****X*X*****X*XX****X**
**X**X**XXXX*X********X*****XX*****XX*X***X*X*XX*X
X***X*X**XX****X*X*XX**X*XX****X*XX*X***X*********
**X****X****XX***X***X******X*X***X***XX*X*X*XX*X*
*X*X*X**X*XX***X***X*XX*X*X*X*X*X***X****XX*****X*
*****XX******X**XX*X**X***X****X**X***X*X***X*XX**
X*X*X***X*X*X*X*****X***X***XX*X*X**X**XX*X***X**X
*****X*X*******X*XX**X*X*XX*****X*X**X****X*X***XX
*X*X*****X*X*X*****X******X*X*X*X***XX*X*X****X**X
**X*X*XX***X*X*X*X***XX*X********XX*X****XX*X*XX**
X*******X*X******X*X*****XX*XX*X**X***XX***X***XX*
**XX*XX**X**X*XX****X*X*XXX**X**X**XX***XX**XX****
X******X**X*X***X*X*X****X*X**X*XX****X*X*X*X**X*X
**XX*X**X**X**X**X***X*X****X****X*X*XX******X***X
X*****X***X**X*X*X*X****X*X***X*X*******X*XX***X**
*X*XX***XX**X*****X**X*X****X*****X*X*X******X*XX*
******X****X**X*X**X*****X*X*X*X*X*X****XX*X**X***
*XX*X**X*X***XX***X*X*X*X**X*****X***XX******X**X*
*****X***X*X****X*******XX**X*X*X**XX***X*XX***X**
X*XX*X*X***X*XX**X*X*XX***X**X****X***X*X****XX**X
********X*X**X*X*****X*X*X*X***X*XX*X*XX*X*X*X**X*
*X*XX*X*X*X*X**X*X*X*******X*X*X*X**X****X*X***X**
**XX*X***X**XX***X***X*X*XX*****X**X*X*XX****X*X*X
X******X***X***X***X********X*X***X*******X*X*****