***XXXX****
XX*XX****X*
XX**XXX*XX*
XXX*****XX*
XXXXXXXXX**
XXXXX*****X
XXXXXXX**XX
XXXXXXXX***