***XXXX*********XXXX
XX*XX****X*XXXX*XXXX
XX**XXX*XX*XX***XXXX
XXX*****XX*XX**XX**X
XXXXXXXXX**XX*XXX*XX
XXXXX*****XXX*****XX
XXXXXXX**XXXX*XXX*XX
XXXXXXXX***XX*XXX*XX
XXXXXXXXXXXXX*XXXXXX
XXXXXXXXXXXXX*******
